20.ox
..o.........o.....o.
.......o............naknm
.o..oo....o.o.o..o..
o..oo...o.......o.o.
..........oo.....o..wawaw
.o...o.......o......
....o.o.o......o...o
o.......oo......o.o.
o.o..o.............o
oo....o...o...o.o...
.oo.....oo...o.ooo.o
..o.o...............
..o...o....o........
.oo......o..........
o.o.o...o...o.o....o
o......o..........o.
..o..o...o...o......
.........o..o..o.o..
..oo........o...oo..
..o............o..o.
